1111111111111111111111111111111111
1E10C0C0C0C0000C0C000C00000C000001
1010010100100000101001000C00010101
101001001110101000100100C00C010101
101000001C10C0000000CCCC0000CC00C1
1P100100101010100010010C0C0C010101
100000C0C00000C00000CC0C0C0C0C0C11
1111111111111111111111111111111111
1111111111111111111111111111111111